+-+-+-+-+-+
|   |     |
+-+ + +-+ +
|       | |
+ +-+ + + +
|   | | | |
+ +-+-+ + +
| |     | |
+-+ +-+-+ +
|       | |
+-+-+-+-+-+
